x###xx#############
##@####       #   #
# $$   $$  $ $ ...#
#  $$$#    $  #...#
# $   # $$ $$ #...#
###   #  $    #...#
#     # $ $ $ #...#
#    ###### ###...#
## #  #  $ $  #...#
#  ## # $$ $ $##..#
# ..# #  $      #.#
# ..# # $$$ $$$ #.#
##### #       # #.#
xxxx# ######### #.#
xxxx#           #.#
xxxx###############
