xxx####xxxxxxxxxx
xxx#  ###########
xxx#    $   $ $ #
xxx# $# $ #  $  #
xxx#  $ $  #    #
x### $# #  #### #
x#@#$ $ $  ##   #
x#    $ #$#   # #
x#   $    $ $ $ #
x#####  #########
xxx#      #xxxxxx
xxx#      #xxxxxx
xxx#......#xxxxxx
xxx#......#xxxxxx
xxx#......#xxxxxx
xxx########xxxxxx
