xxxxxxxxxxxxxxx
x############xx
x#..  #     ###
x#..  # $  $  #
x#..  #$####  #
x#..    @ ##  #
x#..  # #  $ ##
x###### ##$ $ #
xxx# $  $ $ $ #
xxx#    #     #
xxx############
