xxxxxxxxxxxxxxxxxxx
x$$$x$$$x$xx$x$$$xx
x$xxx$x$x$x$xx$x$xx
x$$$x$x$x$$xxx$x$xx
xxx$x$x$x$x$xx$x$xx
x$$$x$$$x$xx$x$$$xx
xxxxxxxx@xxxxxxxxxx
xxx$$xx$$$x$xx$xxxx
xxx$x$x$x$x$$x$xxxx
xxx$$xx$$$x$x$$xxxx
xxx$x$x$x$x$x$$xxxx
xxx$$xx$x$x$xx$xxxx
xxxxxxxxxxxxxxxxxxx
