xxxxxxxxxxxxxx
xxxxxxxx#####x
xx#######   ##
x## # @## $$ #
x#    $      #
x#  $  ###   #
x### #####$###
x# $  ### ..#x
x# $ $ $ ...#x
x#    ###...#x
x# $$ #x#...#x
x#  ###x#####x
x####xxxxxxxxx
