xxx#######
xxx#     #
xxx# .$. #
xx## $@$ #
xx#  .$. #
xx#      #
xx########
