xxxxxxxxxxx####xxxxx
xxxxxx####x#  #xxxxx
xxxx### @###$ #xxxxx
xxx##      $  #xxxxx
xx##  $ $$## ##xxxxx
xx#  #$##     #xxxxx
xx# # $ $$ # ###xxxx
xx#   $ #  # $ #####
x####    #  $$ #   #
x#### ## $         #
x#.    ###  ########
x#.. ..#x####xxxxxxx
x#...#.#xxxxxxxxxxxx
x#.....#xxxxxxxxxxxx
x#######xxxxxxxxxxxx