xxxxxxxxxxxxx
x######xx###x
x#..  #x##@##
x#..  ###   #
x#..     $$ #
x#..  # # $ #
x#..### # $ #
x#### $ #$  #
xxxx#  $# $ #
xxxx# $  $  #
xxxx#  ##   #
xxxx#########
