xxxxxxxxxxxxxxxxxx
xxxxxxxxxxx#######
xxxxxxxxxxx#  ...#
xxxxxxx#####  ...#
xxxxxxx#      . .#
xxxxxxx#  ##  ...#
xxxxxxx## ##  ...#
xxxxxx### ########
xxxxxx# $$$ ##xxxx
xx#####  $ $ #####
x##   #$ $   #   #
x#@ $  $    $  $ #
x###### $$ $ #####
xxxxxx#      #xxxx
xxxxxx########xxxx
