xxxxx#####xxxxxxxxxx
xxxxx#   #xxxxxxxxxx
xxxxx#$  #xxxxxxxxxx
xxx###  $##xxxxxxxxx
xxx#  $ $ #xxxxxxxxx
x### # ## #xxx######
x#   # ## #####  ..#
x# $  $          ..#
x##### ### #@##  ..#
xxxxx#     #########
xxxxx#######xxxxxxxx