xxxxxxx
x######
x#.   #
x#@$$ #
x##   #
xx##  #
xx##.#x
xxx###x
