xxxxxxxxxxxxxxxxxxx
xxxxxxxxxxx########
xxxxxxxxxxx#  ....#
############  ....#
#    #  $ $   ....#
# $$$#$  $ #  ....#
#  $     $ #  ....#
# $$ #$ $ $########
#  $ #     #xxxxxxx
## #########xxxxxxx
#    #    ##xxxxxxx
#     $   ##xxxxxxx
#  $$#$$  @#xxxxxxx
#    #    ##xxxxxxx
###########xxxxxxxx
