xxxxxxxxx
xxx######
xxx# ..@#
xxx# $$ #
xxx## ###
xxxx# #xx
xxxx# #xx
x#### #xx
x#    ##x
x# #   #x
x#   # #x
x###   #x
xxx#####x
