xxxxxxxxxxxxxxxxxx
xxxxxxxx#####xxxxx
xxxxxxxx#   #####x
xxxxxxxx# #$##  #x
xxxxxxxx#     $ #x
x######### ###   #
x#....  ## $  $###
x#....    $ $$ ##x
x#....  ##$  $ @#x
x########   $  ##x
xxxxxxxx# $ $  #xx
xxxxxxxx### ## #xx
xxxxxxxxxx#    #xx
xxxxxxxxxx######xx
