xxxxxxxxxxxxxxxxxx
xxxxxxxx########xx
xxxxxxxx#     @#xx
xxxxxxxx# $#$ ##xx
xxxxxxxx# $  $#xxx
xxxxxxxx##$ $ #xxx
x######### $ # ###
x#....  ## $  $  #
x##...    $  $   #
x#....  ##########
x########xxxxxxxxx
