xxxxxxx
x####xx
x# .#xx
x#  ###
x#.@  #
x#$ $ #
x#  ###
x####xx
xxxxxxx